11111111111111111111
10000000000000010001
10000000000000010001
10000001111110000001
10000001000011100001
10000001000000000001
10000001000000000001
10000001000000000001
10000001111000000001
10000000001000000001
10000000001000000001
10001000001000000001
10001100001000000001
10000000000000000001
10100010001000100001
10000000000000000001
10000000000001100001
10011110000001100001
10000011110000000001
11111111111111111111